10 15
###############
#.#...#S..##.X#
#..#...@@.....#
#.#...##..#...#
#.....##.##..X#
#.....#...#..@#
#...###..##@..#
#...##..@.#X.##
#...#.....#X.X#
###############
