10 12
############
##.#...#...#
#....#....##
#..#..#....#
##......#X.#
##..S#.....#
#..#######.#
#.......@..#
#...#..#...#
############
