9 15
###############
#......S#X...##
#......#.#..@.#
#.....#...#...#
#....#..#..#..#
#...#..#....#.#
#..#..#..##...#
#....#..#...#.#
###############
