6 12
############
####X@..X###
####....X###
#S....@.@.##
####.....###
############
