6 15
###############
#......#...#.##
#...##...#....#
#..@..###.##.##
#..X#......S..#
###############
