10 15
###############
####.....#..###
##..###...#...#
#.......#..##.#
#..#.###...#X.#
##.#.....#.#S##
#..#########@.#
#.............#
##..#.#.#.#..##
###############
